Apple – Apple Inc.
Nike – Nike Inc.
McDonald's – McDonald's Corporation
Coca-Cola – The Coca-Cola Company
Google – Google LLC
Mercedes-Benz – Mercedes-Benz AG
Adidas – Adidas AG
BMW – Bayerische Motoren Werke AG (BMW)
Pepsi – PepsiCo Inc.
Amazon – Amazon.com, Inc.
Target – Target Corporation
Shell – Royal Dutch Shell plc
IBM – International Business Machines Corporation
Microsoft – Microsoft Corporation
Volkswagen – Volkswagen AG
Starbucks – Starbucks Corporation
Facebook – Facebook, Inc.
Ford – Ford Motor Company
Toyota – Toyota Motor Corporation
General Electric – General Electric Company
Chanel – Chanel S.A.
Gucci – Gucci S.p.A.
Louis Vuitton – Louis Vuitton Malletier S.A.
Ferrari – Ferrari S.p.A.
Twitter – Twitter, Inc.
Instagram – Instagram, Inc.
Mastercard – Mastercard Incorporated
Visa – Visa Inc.
American Express – American Express Company
FedEx – FedEx Corporation
Walt Disney – The Walt Disney Company
Warner Bros. – Warner Bros. Entertainment Inc.
AT&T – AT&T Inc.
Harley-Davidson – Harley-Davidson Motor Company
Rolex – Rolex SA
Airbnb – Airbnb, Inc.
Tesla – Tesla, Inc.
Audi – Audi AG
Honda – Honda Motor Co., Ltd.
Nestlé – Nestlé S.A.
Puma – Puma SE
Unilever – Unilever PLC
3M – 3M Company
Pinterest – Pinterest, Inc.
Snapchat – Snap Inc.
LG – LG Corporation
Levis – Levi Strauss & Co.
The Olympic Rings – International Olympic Committee
World Wildlife Fund (WWF) – World Wide Fund for Nature
NBA – National Basketball Association